T__KER__C_
_R_E___#_R
___##___#_
RE_#__R___
__ER__R___
##_R#_C___
_#R__EE#_#
#_C#__RCR_
__S___#C_C
_#_#_____o
