T___#E#_C_#E
_R_E______K_
##_R______C_
C____R_____#
__CRC#_____E
_C__#_______
R_R_#____E__
_####___#__#
R___C##_##_R
____#_#_S___
E___E_RE#___
__#R__#_ECEo
