TE_______#_
___#R#_C___
___#_R_#_R_
KEC____R___
____RR__#E_
__#_E_____#
_______##__
____EER__#_
#_###R__E__
_S_#_____#_
___#R_E_#_o
