T_R_#R__##__E#_C#___
#_C__E_#__#_E_E_C#_E
___E_#____#___R_C___
___#_##_##_______R__
_C_______C#E_______#
___#__RE__##___E___#
ER_E#K_#_E#_#___#R__
__R___#_R___#___#_R#
CR_#____R__#____#___
__#__##EE_#E____###_
__E__##EE#R#_____R_#
C_EE__EEECR__E#_#E_E
#______#C___ER_R_###
_E__#________##___R_
###__E#____R_#C##S#_
#____R__E_R__#_____#
#___R_##_E_#___##_R_
__#____R___CR_#_____
_##ER__#_____#__#_#_
E_#E_#_____#_#C___Eo
