T_#_E___
E____#__
_#_R___R
_R_##_#_
_#_###__
__K____C
#S_____R
___#___o
