T__E_C__#_E#__#
R_E_#_###____R#
_#___R_____E___
___#____#_#C___
__##R#R_ER#_##R
E#_R_C_E____#_#
__#__R#_E#R__#_
__#_E____##E__#
_______#E__E#__
_#____#_KE#_R_C
#__S___###____#
_#___##R##_##__
R_#E_________E#
___E#____#_#__#
#R___CR#____C_o
