T___#____
CE___#R#_
#E__R_#__
E_#C#_#R_
_S_#EE#_K
E__#___C_
#____#___
______R#_
____##__o
